7, 2, 2, 2, 2, 2, 2, 2, 2, 2, 2, 2, 2, 2, 2, 2, 2, 2, 2, 6, 3, 1, 1, 1, 12, 0, 1, 1, 
1, 1, 1, 1, 1, 1, 12, 0, 1, 1, 1, 3, 18, 1, 1, 1, 1, 1, 1, 1, 1, 1, 1, 1, 1, 1, 
1, 1, 1, 1, 1, 17, 99, 1, 1, 1, 1, 1, 1, 1, 1, 1, 1, 1, 1, 1, 1, 1, 1, 1, 1, 99, 
3, 11, 1, 1, 1, 1, 1, 1, 1, 1, 1, 1, 1, 1, 1, 1, 1, 1, 11, 3, 4, 2, 2, 2, 2, 2, 
2, 2, 6, 1, 1, 7, 2, 2, 2, 2, 2, 2, 2, 5, 0, 0, 0, 0, 0, 0, 0, 0, 3, 1, 1, 3, 
0, 0, 0, 0, 0, 0, 0, 0, 14, 14, 14, 14, 14, 14, 14, 14, 3, 1, 1, 
3, 14, 14, 14, 14, 14, 14, 14, 14, 15, 15, 15, 15, 15, 15, 15, 15, 3, 1, 1, 
3, 15, 15, 15, 15, 15, 15, 15, 15, 15, 15, 15, 15, 15, 15, 15, 15, 3, 1, 1, 
3, 15, 15, 15, 15, 15, 15, 15, 15, 15, 15, 15, 15, 15, 15, 15, 15, 3, 1, 1, 
3, 15, 15, 15, 15, 15, 15, 15, 15, 2, 2, 2, 2, 2, 2, 2, 2, 2, 16, 0, 2, 2, 2, 2, 2, 2, 
2, 2, 2