0, 0, 0, 0, 0, 0, 0, 0, 7, 13, 0, 6, 0, 0, 0, 0, 0, 
0, 0, 0, 0, 0, 0, 0, 0, 0, 0, 0, 3, 1, 1, 3, 0, 0, 0, 0, 0, 0, 0, 0, 0, 0, 0, 
0, 0, 0, 0, 0, 3, 1, 1, 3, 0, 0, 0, 0, 0, 0, 0, 0, 0, 0, 0, 0, 0, 0, 0, 0, 3, 
1, 1, 3, 0, 0, 0, 0, 0, 0, 0, 0, 0, 0, 0, 0, 0, 0, 0, 0, 3, 1, 1, 3, 0, 0, 0, 
0, 0, 0, 0, 0, 7, 2, 2, 2, 2, 2, 2, 2, 5, 1, 1, 4, 2, 2, 2, 2, 2, 2, 2, 6, 3, 
9, 12, 0, 10, 1, 1, 10, 1, 1, 1, 1, 12, 99, 12, 99, 1, 1, 11, 3, 3, 99, 1, 1, 99, 1, 
1, 99, 1, 1, 1, 1, 1, 1, 1, 1, 1, 1, 1, 3, 3, 8, 99, 1, 1, 1, 1, 1, 1, 1, 1, 1, 
1, 1, 1, 1, 1, 1, 1, 3, 3, 1, 1, 1, 1, 1, 1, 1, 1, 1, 1, 1, 1, 1, 1, 1, 1, 1, 
1, 3, 3, 1, 1, 1, 1, 1, 1, 1, 1, 1, 1, 1, 1, 1, 1, 1, 1, 1, 11, 3, 4, 2, 2, 2, 
2, 2, 2, 2, 2, 2, 2, 2, 2, 2, 2, 2, 2, 2, 2, 5