3, 20, 20, 20, 20, 20, 20, 20, 20, 37, 37, 20, 20, 20, 20, 20, 20, 20, 20, 3, 
3, 20, 20, 20, 20, 20, 20, 20, 20, 37, 37, 20, 20, 20, 20, 20, 20, 20, 20, 3, 
3, 20, 20, 20, 20, 20, 20, 20, 20, 37, 37, 20, 20, 20, 20, 20, 20, 20, 20, 3, 
3, 20, 20, 20, 20, 20, 20, 20, 20, 37, 37, 20, 20, 20, 20, 20, 20, 20, 20, 3, 
3, 20, 20, 20, 20, 20, 20, 20, 20, 37, 37, 20, 20, 20, 20, 20, 20, 20, 20, 3, 
3, 20, 20, 20, 20, 20, 20, 20, 20, 37, 37, 20, 20, 20, 20, 20, 20, 20, 20, 3, 
3, 20, 20, 20, 20, 20, 20, 20, 20, 37, 37, 20, 20, 20, 20, 20, 20, 20, 20, 17, 
3, 20, 20, 20, 20, 20, 20, 20, 20, 37, 37, 20, 20, 20, 20, 20, 20, 20, 20, 0, 
3, 20, 20, 20, 20, 20, 20, 20, 20, 37, 37, 20, 20, 20, 20, 20, 20, 20, 20, 3, 
3, 20, 20, 20, 20, 20, 20, 20, 20, 37, 37, 20, 20, 20, 20, 20, 20, 20, 20, 3, 
3, 20, 20, 20, 20, 20, 20, 20, 20, 37, 37, 20, 20, 20, 20, 20, 20, 20, 20, 3, 
4, 2, 2, 2, 2, 2, 2, 2, 2, 16, 0, 2, 2, 2, 2, 2, 2, 2, 2, 5