7, 2, 2, 2, 2, 2, 2, 2, 2, 2, 2, 2, 2, 2, 2, 2, 2, 2, 2, 6, 
3, 20, 20, 20, 20, 20, 20, 20, 20, 20, 20, 20, 20, 20, 34, 34, 3, 19, 19, 17, 
3, 20, 7, 2, 2, 2, 2, 6, 20, 20, 20, 20, 20, 34, 34, 34, 3, 19, 19, 0, 
3, 20, 3, 19, 19, 19, 19, 3, 20, 20, 20, 20, 20, 20, 20, 34, 3, 19, 19, 3, 
3, 20, 3, 19, 19, 19, 19, 19, 19, 19, 19, 19, 19, 19, 19, 19, 19, 19, 19, 3, 
3, 20, 3, 19, 19, 19, 19, 19, 19, 19, 19, 19, 19, 19, 19, 19, 19, 19, 19, 3, 
3, 20, 3, 19, 19, 19, 19, 3, 20, 19, 19, 20, 20, 20, 20, 20, 20, 20, 20, 3, 
3, 20, 4, 2, 2, 2, 2, 5, 20, 19, 19, 20, 20, 20, 20, 20, 20, 20, 20, 3, 
3, 20, 20, 20, 20, 20, 20, 20, 20, 19, 19, 20, 20, 20, 20, 20, 20, 20, 20, 3, 
3, 20, 20, 20, 20, 20, 20, 20, 20, 19, 19, 20, 20, 20, 20, 20, 20, 20, 20, 3, 
3, 20, 20, 20, 20, 20, 20, 20, 20, 19, 19, 20, 20, 20, 20, 20, 20, 20, 20, 3, 
4, 2, 2, 33, 2, 2, 33, 2, 2, 16, 0, 2, 2, 33, 2, 2, 33, 2, 2, 5