{
  "width": 18,
  "height": 24,
  "tiles": [
    7, 2, 2, 31, 2, 2, 31, 2, 2, 13, 0, 2, 2, 31, 2, 2, 31,
    2, 2, 6, 32, 1, 1, 1, 1, 1, 1, 1, 1, 1, 1, 1, 1, 1, 1, 1, 1, 1, 1, 3, 3, 1, 1,
    1, 1, 1, 1, 1, 1, 22, 0, 1, 1, 1, 1, 1, 1, 1, 1, 17, 3, 11, 1, 1, 24, 24, 1, 1, 1,
    0, 0, 1, 1, 1, 1, 1, 1, 1, 1, 0, 32, 1, 1, 1, 30, 30, 1, 1, 1, 22, 0, 1, 1, 1, 1,
    1, 1, 1, 1, 3, 3, 1, 1, 26, 0, 0, 27, 1, 1, 0, 0, 1, 1, 1, 1, 1, 1, 1, 1, 3, 3,
    1, 1, 1, 29, 29, 1, 1, 1, 22, 0, 1, 1, 1, 1, 1, 1, 1, 1, 3, 32, 1, 1, 1, 0, 0, 1,
    1, 1, 0, 0, 1, 1, 1, 1, 1, 1, 1, 1, 3, 3, 11, 1, 26, 28, 28, 27, 1, 1, 22, 0, 1, 1,
    1, 1, 1, 1, 1, 11, 3, 3, 1, 1, 1, 0, 0, 1, 1, 1, 0, 0, 1, 1, 1, 1, 1, 1, 1, 1,
    3, 32, 1, 1, 1, 25, 25, 1, 1, 1, 22, 0, 1, 1, 1, 1, 1, 1, 1, 1, 3, 3, 1, 1, 1, 1,
    1, 1, 1, 1, 0, 0, 1, 1, 1, 1, 1, 1, 1, 1, 3,
    3, 1, 1, 1, 1, 1, 1, 1, 1, 22, 0, 1, 1, 1, 1, 1, 1,
    1, 1, 3, 3, 1, 1, 1, 1, 1, 1, 1, 1, 0, 0, 1, 1, 1, 1, 1, 1, 1, 1, 3, 32, 1, 1,
    1, 1, 1, 1, 1, 1, 22, 0, 1, 1, 1, 1, 1, 1, 1, 1, 3, 3, 1, 1, 1, 1, 1, 1, 1, 1,
    0, 0, 1, 1, 1, 1, 1, 1, 1, 1, 3, 3, 1, 1, 1, 1, 1, 1, 1, 1, 22, 0, 1, 1, 1, 1,
    1, 1, 1, 11, 3, 3, 1, 1, 1, 1, 1, 1, 1, 1, 0, 0, 1, 1, 1, 1, 1, 1, 1, 1, 3,
    18, 1, 1, 35, 0, 35, 0, 35, 0, 36, 0, 35, 0, 35, 0, 35, 0, 38, 0, 3, 0, 1, 1, 0, 0, 0,
    0, 0, 0, 0, 0, 0, 0, 0, 0, 0, 0, 0, 0, 3, 3, 1, 1, 1, 1, 1, 1, 1, 1, 1, 1, 1,
    1, 1, 1, 1, 1, 1, 1, 3, 3, 1, 1, 1, 1, 1, 1, 1, 1, 1, 1, 1, 1, 1, 1, 1, 1,
    1, 11, 3, 3, 1, 1, 1, 1, 1, 1, 1, 1, 1, 1, 1, 1, 1, 1, 1, 1, 1, 1, 3, 4, 2, 2,
    2, 2, 2, 2, 2, 2, 2, 2, 2, 2, 2, 2, 2, 2, 2, 2, 5
  ],
  "entities": [
    [32, 32, 1, 0, 90, 0, 30],
    [576, 32, 1, 0, 270, 0, 30],
    [32, 300, 1, 0, 90, 0, 30],
    [576, 300, 1, 0, 270, 0, 30]
  ]
}
