7, 2, 2, 2, 2, 2, 2, 2, 2, 2, 2, 2, 2, 2, 2, 2, 2, 2, 2, 2, 
3, 20, 20, 20, 20, 20, 19, 19, 20, 20, 20, 3, 21, 21, 21, 21, 21, 21, 21, 21, 
18, 19, 19, 19, 19, 19, 19, 19, 20, 20, 20, 3, 21, 21, 21, 21, 21, 21, 21, 21, 
0, 19, 19, 19, 19, 19, 19, 19, 20, 20, 20, 3, 21, 21, 21, 21, 21, 21, 21, 21, 
3, 20, 20, 20, 20, 20, 20, 20, 20, 20, 20, 3, 21, 21, 21, 21, 21, 21, 21, 21, 
3, 20, 20, 20, 20, 20, 20, 20, 20, 20, 20, 3, 21, 21, 21, 21, 21, 21, 21, 21, 
3, 20, 20, 20, 20, 20, 20, 20, 20, 20, 20, 3, 21, 21, 21, 21, 21, 21, 21, 21, 
3, 20, 20, 20, 20, 20, 20, 20, 20, 20, 20, 3, 21, 21, 21, 21, 21, 21, 21, 21, 
3, 20, 20, 20, 20, 20, 20, 20, 20, 20, 20, 3, 21, 21, 21, 21, 21, 21, 21, 21, 
3, 20, 20, 20, 20, 20, 20, 20, 20, 20, 20, 3, 21, 21, 21, 21, 21, 21, 21, 21, 
3, 20, 20, 20, 20, 20, 20, 20, 20, 20, 20, 3, 21, 21, 21, 21, 21, 21, 21, 21, 
4, 2, 2, 2, 2, 2, 2, 2, 2, 2, 2, 2, 2, 2, 2, 2, 2, 2, 2, 2