7, 2, 2, 31, 2, 2, 31, 2, 2, 13, 0, 2, 2, 31, 2, 2, 31, 
2, 2, 6, 32, 1, 1, 1, 1, 1, 1, 1, 1, 1, 1, 1, 1, 1, 1, 1, 1, 1, 1, 3, 3, 1, 1, 
1, 1, 1, 1, 1, 1, 22, 0, 1, 1, 1, 1, 1, 1, 1, 1, 17, 3, 11, 1, 1, 24, 24, 1, 1, 1, 
0, 0, 1, 1, 1, 1, 1, 1, 1, 1, 0, 32, 1, 1, 1, 30, 30, 1, 1, 1, 22, 0, 1, 1, 1, 1, 
1, 1, 1, 1, 3, 3, 1, 1, 26, 0, 0, 27, 1, 1, 0, 0, 1, 1, 1, 1, 1, 1, 1, 1, 3, 3, 
1, 1, 1, 29, 29, 1, 1, 1, 22, 0, 1, 1, 1, 1, 1, 1, 1, 1, 3, 32, 1, 1, 1, 0, 0, 1, 
1, 1, 0, 0, 1, 1, 1, 1, 1, 1, 1, 1, 3, 3, 11, 1, 26, 28, 28, 27, 1, 1, 22, 0, 1, 1, 
1, 1, 1, 1, 1, 11, 3, 3, 1, 1, 1, 0, 0, 1, 1, 1, 0, 0, 1, 1, 1, 1, 1, 1, 1, 1, 
3, 32, 1, 1, 1, 25, 25, 1, 1, 1, 22, 0, 1, 1, 1, 1, 1, 1, 1, 1, 3, 3, 1, 1, 1, 1, 
1, 1, 1, 1, 0, 0, 1, 1, 1, 1, 1, 1, 1, 1, 3