7, 2, 2, 2, 2, 2, 2, 2, 2, 13, 0, 2, 2, 2, 2, 2, 2, 2, 2, 2, 
3, 20, 20, 20, 20, 20, 20, 20, 20, 37, 37, 20, 20, 19, 20, 20, 20, 20, 20, 20, 
3, 20, 20, 20, 20, 20, 20, 20, 20, 37, 37, 20, 20, 19, 20, 20, 20, 20, 20, 20, 
3, 20, 20, 20, 20, 20, 20, 20, 20, 37, 37, 20, 20, 19, 20, 20, 20, 20, 20, 20, 
3, 20, 20, 20, 20, 20, 20, 20, 20, 37, 37, 20, 20, 19, 20, 20, 20, 20, 20, 20, 
3, 20, 20, 20, 20, 20, 20, 20, 20, 37, 37, 37, 37, 37, 37, 37, 37, 37, 37, 37, 
3, 19, 19, 19, 19, 19, 19, 19, 19, 37, 37, 37, 37, 37, 37, 37, 37, 37, 37, 37, 
3, 20, 20, 20, 20, 20, 20, 20, 20, 20, 20, 20, 20, 20, 20, 20, 20, 20, 20, 20, 
3, 20, 20, 20, 20, 20, 20, 20, 20, 20, 20, 20, 20, 20, 20, 20, 20, 20, 20, 20, 
3, 20, 20, 20, 20, 20, 20, 20, 20, 20, 20, 20, 20, 20, 20, 20, 20, 20, 20, 20, 
3, 20, 20, 20, 20, 20, 20, 20, 20, 20, 20, 20, 20, 20, 20, 20, 20, 20, 20, 20, 
3, 20, 20, 20, 20, 20, 20, 20, 20, 20, 20, 20, 20, 20, 20, 20, 20, 20, 20, 20